NO ./textures/photo1.png
SO ./textures/photo1.png
WE ./textures/photo2.png
EA ./textures/photo2.png



F 126,126,255
C 126,255,126

111111111111111111111
100000000000000000001
100000000000000000001
100000000000000000001
100000000000000000001
10000000000S000000001
100000000000000000001
100011100000000000001
100000000100000000001
100000000001000000001
100000000100000000001
111111111100000000001
100000000100000000001
100000000100000000001
100000000100000000001
100000000000000000001
100000000000000000001
100000000000000000001
110000010011100000001
111111111111111111111