11111111
10100001
10000001
11111111