NO textures/simonkraft/wet_sponge.xpm
SO textures/simonkraft/wet_sponge.xpm
WE textures/simonkraft/wet_sponge.xpm
EA textures/simonkraft/wet_sponge.xpm

F 0,0,0
C 153,204,255

111111111111111111111
111111111111111111111
1111W111111 111111111
1111111111  111111111