F 173,164,140
C 192,223,239
NO ./textures/photo8.png
SO ./textures/photo9.png
WE ./textures/photo8.png
EA ./textures/photo9.png

1111111111
1000000001
1000E00001
1000000001
1111111111