F 0,0,0
NO ./textures/photo12.png
SO ./textures/photo13.png
WE ./textures/photo12.png
EA ./textures/photo13.png
C 255,255,255

  111111111111111111
 11000000000000000011
1110000000000000E00111
 1100001111110000011
  111111     1111111