NO ./textures/photo1.png
SO ./textures/photo1.png
WE ./textures/photo2.png
EA ./textures/photo2.png


F 0,0,0
C 153,204,255

111111111111111111111
111111111111111111111
1111000000001111111  
111111111         0 
111111111111111 111  